Census track code,GEO Identification,Tract Name,Area Land,Area Water,Latitude Centroid,Longitude Centroid,Population,Male,Female,Sex ratio (males per 100 females),Median age (years),Under 18 years,16 years and over,18 years and over,21 years and over,65 years and over,85 years and over,18 years and over: Male,18 years and over: Female,18 years and over: Sex ratio (males per 100 females),65 years and over: Male,65 years and over: Female,65 years and over: Sex ratio (males per 100 females),RACE: One race,RACE: Two or more races,RACE: One race: White,RACE: One race: Black or African American,Total housing units,"Citizen, 18 and over","Citizen, 18 and over: Male","Citizen, 18 and over: Female"
9807,11001009807,98.07,1037012,0,38.8292038,-77.0117577,3611,2013,1598,126,40.5,882,2729,2729,2629,478,25,1488,1241,119.9,233,245,95.1,3507,104,94,3247,1802,2717,1476,1241
9802,11001009802,98.02,200745,0,38.8307312,-76.9965578,1913,880,1033,85.2,33.7,534,1404,1379,1323,390,18,593,786,75.4,168,222,75.7,1907,6,14,1876,954,1379,593,786
9803,11001009803,98.03,531060,3756,38.8356929,-77.0043421,3334,1709,1625,105.2,34.1,915,2491,2419,2318,351,46,1211,1208,100.2,190,161,118,3075,259,55,3006,1671,2378,1170,1208
2002,11001002002,20.02,849376,0,38.9525009,-77.0310824,4252,2159,2093,103.2,37.6,1062,3213,3190,3072,511,42,1559,1631,95.6,225,286,78.7,3753,499,1474,1881,1636,2722,1177,1545
2101,11001002101,21.01,600992,0,38.9559119,-77.0241312,5626,2869,2757,104.1,38.1,1304,4382,4322,4101,508,50,2074,2248,92.3,252,256,98.4,5168,458,806,3437,2486,3416,1530,1886
2900,11001002900,29,300632,0,38.9338478,-77.0299131,4497,2315,2182,106.1,31.2,918,3619,3579,3545,390,46,1942,1637,118.6,253,137,184.7,4096,401,2270,1083,1882,3162,1727,1435
3100,11001003100,31,296819,0,38.930617,-77.0254235,3711,1816,1895,95.8,33,603,3165,3108,3030,265,52,1493,1615,92.4,53,212,25,3553,158,1766,752,1825,2595,1233,1362
3200,11001003200,32,447929,0,38.9322375,-77.0211591,4646,2347,2299,102.1,32.9,1143,3538,3503,3409,434,23,1735,1768,98.1,111,323,34.4,4439,207,1503,2096,2042,2901,1427,1474
3400,11001003400,34,911458,159593,38.9221674,-77.0177044,4711,1771,2940,60.2,21.9,357,4433,4354,2426,180,0,1633,2721,60,63,117,53.8,4167,544,1519,2240,1403,4169,1613,2556
3500,11001003500,35,382021,0,38.9223765,-77.024341,4619,2165,2454,88.2,24.5,359,4341,4260,3205,176,38,1955,2305,84.8,59,117,50.4,4399,220,1291,2525,1875,3888,1741,2147
5302,11001005302,53.02,117635,0,38.9124517,-77.0386443,2539,1401,1138,123.1,31.5,190,2370,2349,2349,157,11,1290,1059,121.8,90,67,134.3,2385,154,1895,0,1758,2021,1175,846
4402,11001004402,44.02,274746,0,38.9155152,-77.0270354,2602,1383,1219,113.5,34.3,235,2369,2367,2256,219,0,1253,1114,112.5,141,78,180.8,2227,375,1505,456,1284,2322,1245,1077
10602,11001010602,106.02,542509,0,38.9033936,-76.9994636,5726,2822,2904,97.2,33,867,4995,4859,4767,364,20,2255,2604,86.6,134,230,58.3,5408,318,3238,1708,3026,4658,2195,2463
804,11001000804,8.04,2566768,167978,38.9221746,-77.0918347,3835,1788,2047,87.3,36.1,930,3016,2905,2361,597,20,1311,1594,82.2,249,348,71.6,3704,131,3160,261,1347,2684,1213,1471
4001,11001004001,40.01,271037,2414,38.9208738,-77.0462674,4605,2193,2412,90.9,33.1,489,4116,4116,4116,457,25,1946,2170,89.7,228,229,99.6,4342,263,3468,567,2547,3903,1856,2047
4002,11001004002,40.02,194755,0,38.9181186,-77.0437209,3162,1435,1727,83.1,37.2,327,2858,2835,2830,448,26,1189,1646,72.2,64,384,16.7,2900,262,2389,185,2406,2475,953,1522
3600,11001003600,36,305616,0,38.9236744,-77.0296273,4517,2104,2413,87.2,35,344,4175,4173,4171,290,18,1807,2366,76.4,57,233,24.5,4365,152,2521,1357,2332,3773,1531,2242
4201,11001004201,42.01,204529,0,38.9162076,-77.0388456,3771,1953,1818,107.4,30.6,398,3373,3373,3373,169,0,1752,1621,108.1,112,57,196.5,3685,86,3409,137,2307,3122,1614,1508
4202,11001004202,42.02,207646,0,38.9134023,-77.0430254,2592,1348,1244,108.4,32.2,64,2528,2528,2499,222,2,1333,1195,111.5,71,151,47,2187,405,1838,54,1649,2168,1171,997
7407,11001007407,74.07,608700,0,38.8574823,-76.9850206,3416,1444,1972,73.2,30.9,1143,2520,2273,2190,200,7,748,1525,49,87,113,77,3342,74,78,3239,1564,2232,748,1484
6801,11001006801,68.01,244750,0,38.8877413,-76.9801087,2298,1241,1057,117.4,35.8,365,1933,1933,1904,106,6,1048,885,118.4,44,62,71,1987,311,1151,725,1143,1901,1031,870
10700,11001010700,107,891588,0,38.9039988,-77.0419809,1658,795,863,92.1,32.6,33,1625,1625,1577,195,0,782,843,92.8,84,111,75.7,1557,101,1261,56,1443,1321,630,691
9604,11001009604,96.04,503381,65762,38.8931572,-76.9585043,2414,845,1569,53.9,29.9,624,1806,1790,1771,350,58,575,1215,47.3,99,251,39.4,2399,15,67,2299,930,1748,561,1187
201,11001000201,2.01,505004,0,38.9092171,-77.0743418,3938,1555,2383,65.3,19.9,39,3938,3899,824,22,3,1545,2354,65.6,22,0,,3601,337,2304,299,0,3396,1381,2015
300,11001000300,3,1042157,2305,38.9179099,-77.0748728,5966,2819,3147,89.6,32.2,1160,4957,4806,4633,569,0,2402,2404,99.9,291,278,104.7,5475,491,4946,184,2743,4157,2003,2154
400,11001000400,4,1541239,69,38.9227989,-77.0649214,1500,638,862,74,46,298,1245,1202,1170,277,72,548,654,83.8,124,153,81,1362,138,1008,29,773,1066,473,593
502,11001000502,5.02,581507,0,38.9283547,-77.0595624,3481,1460,2021,72.2,38,614,2878,2867,2819,476,26,1271,1596,79.6,208,268,77.6,3151,330,2625,225,1822,2650,1201,1449
4801,11001004801,48.01,317222,0,38.9117413,-77.0195344,2997,1592,1405,113.3,33.4,289,2729,2708,2694,433,0,1514,1194,126.8,190,243,78.2,2831,166,1516,869,1556,2539,1477,1062
4802,11001004802,48.02,288793,0,38.9062118,-77.0188917,3317,1727,1590,108.6,37.5,500,2901,2817,2813,349,9,1408,1409,99.9,130,219,59.4,3128,189,1101,1203,1854,2538,1250,1288
4902,11001004902,49.02,263879,0,38.9058867,-77.0243932,3333,1571,1762,89.2,32.9,306,3078,3027,3027,117,0,1431,1596,89.7,34,83,41,3044,289,1953,678,2139,2798,1313,1485
7401,11001007401,74.01,1209113,200980,38.8675208,-76.9991203,1562,599,963,62.2,37.9,297,1283,1265,1208,388,21,470,795,59.1,136,252,54,1562,0,104,1296,1044,1167,426,741
7403,11001007403,74.03,330904,0,38.8484714,-76.9743805,2615,1168,1447,80.7,28.3,826,1840,1789,1770,76,11,674,1115,60.4,24,52,46.2,2615,0,0,2237,1127,1775,660,1115
5503,11001005503,55.03,213338,4682,38.9062488,-77.0523495,1812,833,979,85.1,35.6,29,1783,1783,1476,191,32,804,979,82.1,60,131,45.8,1812,0,1552,45,1471,1508,618,890
5801,11001005801,58.01,232951,0,38.8975634,-77.0205095,1872,793,1079,73.5,43.1,92,1780,1780,1780,265,10,749,1031,72.6,139,126,110.3,1838,34,1344,213,1521,1657,718,939
9804,11001009804,98.04,518363,5609,38.8420148,-76.997258,2668,1045,1623,64.4,25.9,821,1954,1847,1714,194,0,621,1226,50.7,81,113,71.7,2530,138,51,2370,1101,1822,605,1217
1702,11001001702,17.02,939295,0,38.9717231,-77.0160682,3610,1405,2205,63.7,37.9,616,3049,2994,2828,467,106,1164,1830,63.6,159,308,51.6,3447,163,1804,1445,1852,2907,1144,1763
10300,11001010300,103,1084591,0,38.9761556,-77.0271875,4055,1937,2118,91.5,42.5,924,3320,3131,3049,496,86,1461,1670,87.5,102,394,25.9,3795,260,756,2060,1591,2673,1188,1485
1804,11001001804,18.04,601755,0,38.9670945,-77.0304334,5279,2426,2853,85,40.4,1635,3644,3644,3619,767,65,1435,2209,65,321,446,72,5044,235,366,2940,2215,2676,977,1699
4600,11001004600,46,437422,0,38.9097456,-77.0133001,3031,1365,1666,81.9,34.1,309,2730,2722,2722,415,60,1302,1420,91.7,193,222,86.9,2944,87,1426,1379,1571,2696,1293,1403
1901,11001001901,19.01,769304,0,38.9646853,-77.0236327,4456,2087,2369,88.1,36.6,1170,3480,3286,3140,707,69,1647,1639,100.5,378,329,114.9,4115,341,977,2771,1826,2872,1427,1445
5001,11001005001,50.01,200969,0,38.9119619,-77.0295088,1922,1109,813,136.4,37.2,95,1827,1827,1827,143,0,1061,766,138.5,67,76,88.2,1874,48,1460,228,1209,1758,1035,723
10202,11001010202,102.02,1069479,136323,38.8843563,-77.024577,1960,881,1079,81.6,36.6,237,1747,1723,1713,344,40,786,937,83.9,118,226,52.2,1777,183,951,628,1262,1555,677,878
980000,11001980000,9800,6514228,4996439,38.8809933,-77.0363219,17,17,0,,,0,17,17,17,0,0,17,0,,0,0,,17,0,17,0,5,17,17,0
7202,11001007202,72.02,183977,0,38.8786426,-77.0070741,3836,1925,1911,100.7,30.3,162,3674,3674,3674,119,0,1809,1865,97,44,75,58.7,3720,116,3230,289,2810,3641,1808,1833
5202,11001005202,52.02,246292,0,38.911127,-77.0344946,2683,1643,1040,158,37.6,0,2683,2683,2683,416,0,1643,1040,158,286,130,220,2585,98,2372,182,2144,2589,1607,982
5203,11001005203,52.03,93419,0,38.9077655,-77.0331441,3470,1561,1909,81.8,34,233,3237,3237,3237,453,0,1473,1764,83.5,0,453,,3201,269,1876,575,2757,2599,1112,1487
5003,11001005003,50.03,94136,0,38.9074041,-77.0307609,1619,993,626,158.6,35.9,18,1601,1601,1601,53,0,975,626,155.8,28,25,112,1505,114,1120,211,1270,1385,871,514
5004,11001005004,50.04,143156,0,38.907252,-77.0283862,4120,2519,1601,157.3,33.8,468,3673,3652,3652,551,37,2262,1390,162.7,305,246,124,3862,258,2041,1304,2527,3256,2034,1222
5802,11001005802,58.02,682488,0,38.8979674,-77.0265766,1936,1126,810,139,46,24,1912,1912,1912,164,0,1114,798,139.6,95,69,137.7,1744,192,1321,165,1712,1659,996,663
4703,11001004703,47.03,124124,0,38.9034762,-77.0170713,3101,1628,1473,110.5,32.8,185,2916,2916,2810,155,3,1443,1473,98,78,77,101.3,2993,108,1288,524,2239,2244,1032,1212
4704,11001004704,47.04,198509,0,38.904566,-77.0114767,1208,524,684,76.6,37.4,229,1047,979,899,174,19,483,496,97.4,47,127,37,1146,62,42,1103,824,951,483,468
10603,11001010603,106.03,464270,0,38.9011144,-77.0063567,2496,811,1685,48.1,27.3,2,2494,2494,2494,81,0,811,1683,48.2,40,41,97.6,2379,117,1993,287,1825,2417,774,1643
10601,11001010601,106.01,224811,0,38.907653,-77.0063018,1916,898,1018,88.2,29.7,114,1802,1802,1802,4,1,856,946,90.5,1,3,33.3,1721,195,1000,484,1279,1732,842,890
11002,11001011002,110.02,498122,367023,38.8681789,-77.0182455,1519,697,822,84.8,50.7,40,1479,1479,1473,431,61,657,822,79.9,125,306,40.8,1411,108,1078,240,1320,1447,625,822
10201,11001010201,102.01,174884,0,38.8779576,-77.0184625,2522,1450,1072,135.3,33.6,211,2311,2311,2310,235,0,1302,1009,129,108,127,85,2202,320,1313,695,2170,2157,1250,907
11001,11001011001,110.01,152450,0,38.8741656,-77.0157419,2385,1108,1277,86.8,42.5,65,2320,2320,2320,261,45,1069,1251,85.5,110,151,72.8,2269,116,1420,791,1533,2311,1069,1242
7203,11001007203,72.03,384178,0,38.8781777,-76.9994857,2885,1206,1679,71.8,34.3,467,2431,2418,2418,270,37,973,1445,67.3,162,108,150,2747,138,1758,840,1800,2418,973,1445
7201,11001007201,72.01,781457,312419,38.8738481,-76.9999179,1893,1029,864,119.1,32.1,0,1893,1893,1855,9,0,1029,864,119.1,9,0,,1809,84,1435,183,1551,1786,957,829
9510,11001009510,95.1,841510,0,38.9455978,-77.0046255,4853,2691,2162,124.5,31.9,1565,3382,3288,3155,577,38,1581,1707,92.6,117,460,25.4,4629,224,272,3067,1978,2371,991,1380
9511,11001009511,95.11,719468,0,38.9372097,-77.0010516,2016,817,1199,68.1,19.9,25,2016,1991,453,48,14,809,1182,68.4,11,37,29.7,1904,112,1424,271,0,1786,689,1097
600,11001000600,6,1441865,71,38.9368114,-77.0675114,4688,2011,2677,75.1,46.5,846,3986,3842,3820,1082,115,1733,2109,82.2,515,567,90.8,4487,201,3750,407,2263,3574,1650,1924
702,11001000702,7.02,308967,0,38.9241271,-77.077893,2865,1163,1702,68.3,34.2,115,2774,2750,2727,412,40,1125,1625,69.2,224,188,119.1,2615,250,2178,328,2460,2359,941,1418
7404,11001007404,74.04,826388,0,38.8503364,-76.9820932,3799,1782,2017,88.3,27.4,1288,2618,2511,2465,138,0,1008,1503,67.1,68,70,97.1,3761,38,65,3467,1537,2501,1008,1493
7301,11001007301,73.01,4684643,5139082,38.834928,-77.024445,4910,2741,2169,126.4,25.4,1900,3039,3010,2844,59,0,1821,1189,153.2,10,49,20.4,4383,527,2893,1176,1499,2896,1789,1107
3902,11001003902,39.02,266513,11205,38.9257717,-77.0452397,1743,866,877,98.7,33.1,255,1563,1488,1488,171,16,702,786,89.3,86,85,101.2,1518,225,1272,27,1187,1347,641,706
903,11001000903,9.03,928101,0,38.9376821,-77.093331,4119,1733,2386,72.6,19.5,296,3868,3823,1189,209,27,1575,2248,70.1,78,131,59.5,3928,191,3265,377,415,3473,1383,2090
1004,11001001004,10.04,1471925,0,38.9487665,-77.0853886,4330,1952,2378,82.1,42,1050,3377,3280,3130,877,164,1429,1851,77.2,439,438,100.2,4011,319,3504,183,1705,3008,1283,1725
102,11001000102,1.02,1706484,516665,38.905422,-77.0620045,3227,1564,1663,94,52.7,335,2892,2892,2870,855,152,1440,1452,99.2,455,400,113.8,3112,115,2759,32,2076,2589,1288,1301
3701,11001003701,37.01,172840,0,38.9214487,-77.0342887,2084,1008,1076,93.7,34.3,219,1926,1865,1817,111,21,932,933,99.9,50,61,82,1872,212,1209,237,1382,1792,898,894
101,11001000101,1.01,199776,5261,38.9076994,-77.0547765,1281,661,620,106.6,44.7,103,1178,1178,1178,336,29,607,571,106.3,209,127,164.6,1241,40,1200,0,841,1110,539,571
703,11001000703,7.03,232137,0,38.9290941,-77.0790462,3180,1451,1729,83.9,64.8,93,3087,3087,3062,1587,244,1397,1690,82.7,626,961,65.1,2849,331,2367,321,2273,2810,1244,1566
3901,11001003901,39.01,120715,0,38.9254851,-77.0401076,2551,1107,1444,76.7,38.6,149,2402,2402,2402,137,0,1065,1337,79.7,121,16,756.3,2331,220,1508,676,1940,2128,885,1243
4401,11001004401,44.01,246895,0,38.9186825,-77.0282129,3432,1942,1490,130.3,33.7,616,2816,2816,2816,185,35,1492,1324,112.7,84,101,83.2,3312,120,2003,957,1859,2515,1296,1219
1003,11001001003,10.03,982460,0,38.9492362,-77.0930741,2984,1570,1414,111,46.1,866,2146,2118,2112,543,89,1052,1066,98.7,267,276,96.7,2711,273,2450,65,1129,1918,961,957
3802,11001003802,38.02,207186,0,38.922971,-77.0393505,3430,1712,1718,99.7,34.7,315,3115,3115,2996,152,75,1646,1469,112,75,77,97.4,3097,333,1697,594,2016,2528,1331,1197
2703,11001002703,27.03,163863,0,38.9334921,-77.0397435,2289,1307,982,133.1,43.1,279,2010,2010,1989,272,52,1127,883,127.6,92,180,51.1,2147,142,1528,499,1243,1865,1006,859
3702,11001003702,37.02,119532,0,38.9249042,-77.0343972,3088,998,2090,47.8,29.9,837,2251,2251,2203,91,0,858,1393,61.6,42,49,85.7,3011,77,1037,1760,1674,2232,839,1393
803,11001000803,8.03,308153,0,38.9336425,-77.0835217,2442,894,1548,57.8,38.3,374,2068,2068,1752,580,65,714,1354,52.7,208,372,55.9,2358,84,1695,187,1495,1706,615,1091
904,11001000904,9.04,2024710,75151,38.9366243,-77.1036767,3130,1568,1562,100.4,48.3,770,2448,2360,2329,880,96,1098,1262,87,439,441,99.5,3032,98,2570,369,1274,2128,1051,1077
704,11001000704,7.04,332346,0,38.9300215,-77.0752384,2571,1239,1332,93,38.5,240,2348,2331,2171,370,15,1080,1251,86.3,134,236,56.8,2497,74,1911,129,1629,2062,965,1097
1304,11001001304,13.04,707155,9432,38.9367508,-77.0554702,4477,2433,2044,119,37.6,148,4329,4329,4329,566,111,2285,2044,111.8,308,258,119.4,3822,655,3310,257,3084,3614,1966,1648
1303,11001001303,13.03,889581,5274,38.9446266,-77.0589323,3506,1445,2061,70.1,34,69,3437,3437,3437,785,207,1411,2026,69.6,349,436,80,3403,103,2764,344,2296,3136,1200,1936
2704,11001002704,27.04,295339,2427,38.9345766,-77.0427534,3586,2019,1567,128.8,30.5,436,3159,3150,3044,103,0,1696,1454,116.6,76,27,281.5,3292,294,1486,678,1922,2186,1143,1043
2503,11001002503,25.03,292105,0,38.9386375,-77.0271734,2925,1678,1247,134.6,34.3,274,2651,2651,2645,219,41,1516,1135,133.6,72,147,49,2731,194,1045,1268,1805,2329,1317,1012
2504,11001002504,25.04,311721,0,38.9394498,-77.0329275,3459,1911,1548,123.4,35.4,638,2821,2821,2781,490,65,1560,1261,123.7,269,221,121.7,3128,331,1566,783,1428,2096,1107,989
5601,11001005601,56.01,185309,1275,38.901567,-77.0524317,2450,1218,1232,98.9,28.8,50,2400,2400,2292,360,49,1189,1211,98.2,254,106,239.6,2190,260,1884,0,2261,1995,1066,929
5501,11001005501,55.01,164749,0,38.9052766,-77.0494324,1675,1008,667,151.1,35.5,0,1675,1675,1673,121,0,1008,667,151.1,53,68,77.9,1553,122,1527,1,1513,1568,934,634
5602,11001005602,56.02,273491,6261,38.8988888,-77.0554558,4309,1888,2421,78,26.8,127,4186,4182,3003,732,63,1873,2309,81.1,360,372,96.8,4073,236,3088,273,2118,3197,1450,1747
5502,11001005502,55.02,251302,0,38.9101768,-77.0463615,2565,1329,1236,107.5,31.4,137,2428,2428,2399,480,152,1192,1236,96.4,176,304,57.9,2415,150,1848,145,1691,2397,1186,1211
5303,11001005303,53.03,168769,0,38.909613,-77.0391656,2595,1175,1420,82.7,37.8,79,2521,2516,2511,375,17,1141,1375,83,221,154,143.5,2503,92,1931,88,2298,2315,1082,1233
3801,11001003801,38.01,148928,0,38.9197759,-77.0389415,1598,698,900,77.6,34.8,219,1379,1379,1379,130,0,622,757,82.2,55,75,73.3,1452,146,1197,181,1088,1178,511,667
7406,11001007406,74.06,360152,0,38.8555543,-76.9895582,3957,1296,2661,48.7,20.1,1761,2372,2196,1864,69,8,500,1696,29.5,11,58,19,3740,217,0,3476,1454,2129,464,1665
3301,11001003301,33.01,442120,0,38.9204778,-77.0114293,3994,2092,1902,110,36.8,462,3532,3532,3525,205,0,1985,1547,128.3,109,96,113.5,3858,136,2173,1344,1925,3215,1859,1356
7604,11001007604,76.04,1369580,0,38.8660921,-76.9638007,4046,1843,2203,83.7,51.5,674,3487,3372,3300,688,62,1494,1878,79.6,341,347,98.3,3567,479,344,3196,2065,3321,1470,1851
7605,11001007605,76.05,453794,0,38.8660433,-76.9752566,3482,1537,1945,79,49.7,363,3173,3119,3031,1004,204,1282,1837,69.8,224,780,28.7,3378,104,135,3225,2100,3093,1256,1837
7603,11001007603,76.03,1226616,0,38.859109,-76.9585469,4155,1465,2690,54.5,38.4,941,3299,3214,3212,787,134,988,2226,44.4,211,576,36.6,4046,109,142,3872,2411,3213,988,2225
8100,11001008100,81,290284,0,38.893171,-76.9925272,3158,1528,1630,93.7,35.5,488,2686,2670,2643,247,42,1250,1420,88,131,116,112.9,3086,72,2715,209,1644,2597,1240,1357
8200,11001008200,82,338424,0,38.8918309,-77.000604,2884,1258,1626,77.4,32,388,2511,2496,2272,255,8,977,1519,64.3,133,122,109,2490,394,2154,229,1623,2372,918,1454
8302,11001008302,83.02,260891,0,38.8963061,-76.9966527,2874,1514,1360,111.3,34.4,540,2395,2334,2325,244,46,1212,1122,108,135,109,123.9,2601,273,2173,151,1364,2254,1186,1068
8701,11001008701,87.01,382686,0,38.9141018,-77.0062645,2683,1244,1439,86.4,33.9,244,2468,2439,2420,158,32,1110,1329,83.5,33,125,26.4,2645,38,1202,1251,1235,2359,1076,1283
8002,11001008002,80.02,578961,0,38.8915403,-76.9827594,3491,1708,1783,95.8,35.9,867,2657,2624,2621,341,27,1269,1355,93.7,166,175,94.9,3351,140,2575,721,1597,2540,1235,1305
8702,11001008702,87.02,486411,0,38.9150961,-77.0013085,3190,1298,1892,68.6,31.4,236,2997,2954,2822,159,23,1184,1770,66.9,51,108,47.2,2920,270,1270,1558,2052,2867,1117,1750
7703,11001007703,77.03,1017741,1059,38.8863224,-76.947455,7138,3803,3335,114,26.7,2550,4926,4588,4245,568,8,2254,2334,96.6,191,377,50.7,7104,34,29,6708,2448,4315,2030,2285
7707,11001007707,77.07,842851,0,38.8779453,-76.9353432,4580,2536,2044,124.1,32.8,1104,3503,3476,3340,615,115,1863,1613,115.5,321,294,109.2,4348,232,101,4173,2028,3429,1829,1600
7601,11001007601,76.01,1115359,141529,38.8716327,-76.9798185,4931,1893,3038,62.3,37,1050,3910,3881,3796,604,52,1507,2374,63.5,167,437,38.2,4790,141,336,4367,2446,3744,1420,2324
7803,11001007803,78.03,986677,3755,38.8962674,-76.9407751,4555,2152,2403,89.6,37.8,1010,3634,3545,3430,926,6,1701,1844,92.2,450,476,94.5,4392,163,197,4131,2625,3515,1671,1844
7804,11001007804,78.04,838428,5705,38.8942107,-76.9313427,4020,1962,2058,95.3,30,1432,2771,2588,2384,474,96,1025,1563,65.6,262,212,123.6,3886,134,83,3789,1627,2580,1025,1555
8803,11001008803,88.03,1168294,0,38.9104603,-76.9913622,3547,2036,1511,134.7,29.6,451,3153,3096,2720,135,0,1776,1320,134.5,77,58,132.8,3339,208,903,2061,1619,2946,1688,1258
8804,11001008804,88.04,778052,0,38.9102408,-76.9812669,2794,1267,1527,83,37.1,339,2489,2455,2297,238,10,1104,1351,81.7,57,181,31.5,2615,179,391,2137,1795,2286,1056,1230
8903,11001008903,89.03,305651,0,38.9041579,-76.977718,3765,1762,2003,88,31.3,1099,2690,2666,2632,170,22,1322,1344,98.4,42,128,32.8,3664,101,363,3274,1872,2657,1314,1343
2702,11001002702,27.02,479022,7175,38.930168,-77.0421774,5640,2642,2998,88.1,34.5,1072,4583,4568,4511,414,0,2206,2362,93.4,190,224,84.8,4887,753,3105,737,2548,3979,1937,2042
8301,11001008301,83.01,303973,0,38.8970373,-77.0008008,2875,1589,1286,123.6,31.8,368,2507,2507,2465,274,10,1392,1115,124.8,188,86,218.6,2789,86,2295,306,1595,2406,1332,1074
1600,11001001600,16,2667590,7820,38.9849725,-77.0382324,4400,2182,2218,98.4,48.9,919,3637,3481,3429,1133,116,1682,1799,93.5,518,615,84.2,4077,323,1153,2797,1744,3381,1661,1720
10500,11001010500,105,749891,0,38.8818529,-77.0133789,4027,1950,2077,93.9,35.3,373,3700,3654,3532,287,20,1753,1901,92.2,124,163,76.1,3700,327,2051,1460,2488,3284,1605,1679
9204,11001009204,92.04,308465,0,38.9234161,-76.9987071,3249,1495,1754,85.2,31.6,1062,2230,2187,2115,579,30,998,1189,83.9,357,222,160.8,3097,152,228,2490,1557,1866,877,989
7304,11001007304,73.04,1232841,8983,38.8417979,-76.9855591,4523,2079,2444,85.1,32.8,1306,3406,3217,3180,411,30,1472,1745,84.4,217,194,111.9,4475,48,188,4063,2087,3152,1436,1716
3000,11001003000,30,210636,0,38.9288689,-77.0299525,4100,2022,2078,97.3,31,820,3367,3280,3280,257,38,1611,1669,96.5,126,131,96.2,3956,144,1525,1511,1800,2693,1197,1496
7502,11001007502,75.02,648317,0,38.8568592,-76.9697843,5224,2248,2976,75.5,28.9,2033,3412,3191,2922,674,65,1435,1756,81.7,303,371,81.7,5205,19,47,5118,2161,3191,1435,1756
7503,11001007503,75.03,515179,0,38.8640724,-76.98709,2634,1186,1448,81.9,27.4,1017,1742,1617,1559,172,11,714,903,79.1,42,130,32.3,2619,15,159,2433,1102,1609,706,903
902,11001000902,9.02,1867106,307257,38.9285125,-77.1077517,2390,1100,1290,85.3,45.2,686,1788,1704,1599,461,53,769,935,82.2,217,244,88.9,2191,199,1930,223,883,1623,756,867
1500,11001001500,15,4684714,39895,38.9741576,-77.0558797,5889,2852,3037,93.9,47.4,1649,4446,4240,4182,1582,277,2087,2153,96.9,739,843,87.7,5539,350,4533,686,2201,4106,2059,2047
9603,11001009603,96.03,607400,0,38.8918285,-76.9477195,3902,1881,2021,93.1,41.4,667,3312,3235,3097,728,170,1605,1630,98.5,328,400,82,3850,52,12,3643,2000,3109,1508,1601
501,11001000501,5.01,940249,29503,38.9264548,-77.051434,3422,1566,1856,84.4,36.9,304,3154,3118,3019,425,5,1370,1748,78.4,159,266,59.8,3200,222,2357,440,2545,2937,1237,1700
3302,11001003302,33.02,204237,0,38.9139237,-77.0111677,2254,1012,1242,81.5,33.4,405,1868,1849,1822,146,9,918,931,98.6,75,71,105.6,2171,83,992,1069,1014,1800,891,909
8402,11001008402,84.02,274180,0,38.898596,-76.991021,2372,917,1455,63,36,271,2146,2101,2089,279,69,803,1298,61.9,75,204,36.8,2171,201,1357,770,1476,2018,734,1284
9602,11001009602,96.02,1306709,67073,38.9035769,-76.9523616,4648,1836,2812,65.3,33.4,1538,3212,3110,3018,367,0,1187,1923,61.7,126,241,52.3,4359,289,92,4261,2260,2938,1100,1838
802,11001000802,8.02,1688582,669985,38.9126765,-77.0896118,3384,1697,1687,100.6,40.9,698,2725,2686,2651,674,66,1340,1346,99.6,396,278,142.4,3151,233,2591,297,1524,2302,1104,1198
1301,11001001301,13.01,2855501,26550,38.9519215,-77.0520508,4436,1817,2619,69.4,37.2,754,3746,3682,3553,818,274,1471,2211,66.5,254,564,45,4317,119,3208,734,2134,3282,1300,1982
2001,11001002001,20.01,632724,1132,38.9597034,-77.0351061,3581,1732,1849,93.7,35.3,1108,2590,2473,2388,375,14,1263,1210,104.4,179,196,91.3,3454,127,456,1376,1229,1488,711,777
7708,11001007708,77.08,745809,129100,38.8871944,-76.9606349,2370,1064,1306,81.5,35.6,478,1907,1892,1750,500,24,790,1102,71.7,104,396,26.3,2292,78,2,2197,1255,1892,790,1102
1402,11001001402,14.02,895209,0,38.9606051,-77.0630933,3531,1795,1736,103.4,43.6,900,2666,2631,2610,900,248,1314,1317,99.8,380,520,73.1,3264,267,2509,420,1672,2417,1240,1177
4702,11001004702,47.02,326418,0,38.9008601,-77.0136108,3795,1761,2034,86.6,32,147,3648,3648,3642,318,73,1684,1964,85.7,159,159,100,3608,187,2480,746,2415,3321,1530,1791
7504,11001007504,75.04,764081,0,38.8609955,-76.9796257,2760,1524,1236,123.3,30.1,968,1912,1792,1781,235,39,904,888,101.8,100,135,74.1,2675,85,15,2631,1456,1792,904,888
9902,11001009902,99.02,1294556,0,38.8717861,-76.9445542,3159,1724,1435,120.1,48.5,443,2719,2716,2706,503,170,1394,1322,105.4,183,320,57.2,3112,47,86,2915,1369,2594,1375,1219
2600,11001002600,26,2106150,60195,38.9464323,-77.0404553,2535,1264,1271,99.4,42.6,481,2078,2054,2033,578,85,1041,1013,102.8,205,373,55,2335,200,964,1029,936,1809,882,927
8410,11001008410,84.1,219939,0,38.9015543,-76.9911234,2069,1073,996,107.7,34.2,577,1499,1492,1474,122,6,691,801,86.3,33,89,37.1,1707,362,1047,559,798,1478,691,787
9601,11001009601,96.01,1905262,189666,38.90913,-76.9490606,2315,876,1439,60.9,30.8,707,1710,1608,1504,191,17,431,1177,36.6,75,116,64.7,2261,54,47,2178,964,1603,431,1172
202,11001000202,2.02,776435,439661,38.9063048,-77.0696362,4425,1987,2438,81.5,36.1,253,4222,4172,3427,785,31,1840,2332,78.9,314,471,66.7,4208,217,3559,145,1959,3811,1650,2161
4300,11001004300,43,236694,0,38.916804,-77.0341511,4004,1735,2269,76.5,34.4,444,3560,3560,3560,317,67,1608,1952,82.4,137,180,76.1,3286,718,2611,339,2614,3187,1496,1691
6804,11001006804,68.04,1542277,477741,38.8863842,-76.9704836,2816,2415,401,602.2,35.3,39,2777,2777,2603,151,4,2376,401,592.5,39,112,34.8,2804,12,327,2299,29,2690,2329,361
4100,11001004100,41,788701,7303,38.9159337,-77.0516151,2412,921,1491,61.8,37.6,359,2053,2053,2053,462,39,907,1146,79.1,219,243,90.1,2145,267,1596,279,1543,1810,762,1048
10100,11001010100,101,579230,0,38.9026971,-77.0318472,2766,1275,1491,85.5,34.6,55,2711,2711,2711,319,74,1266,1445,87.6,169,150,112.7,2542,224,1850,303,1998,2294,1130,1164
4901,11001004901,49.01,271866,0,38.9113296,-77.0244761,3269,1609,1660,96.9,32.3,314,2967,2955,2749,311,6,1438,1517,94.8,152,159,95.6,3158,111,1972,1090,2012,2868,1379,1489
5900,11001005900,59,641993,0,38.8959944,-77.0149475,2408,1376,1032,133.3,31.1,37,2384,2371,2243,144,10,1368,1003,136.4,59,85,69.4,2327,81,1767,404,1638,2233,1288,945
9901,11001009901,99.01,2102150,0,38.8753461,-76.9553332,2290,1068,1222,87.4,49.9,333,1997,1957,1943,741,250,920,1037,88.7,269,472,57,2212,78,227,1698,1098,1913,896,1017
7901,11001007901,79.01,402041,0,38.8965543,-76.9804319,4950,2442,2508,97.4,32.7,1394,3631,3556,3456,763,60,1739,1817,95.7,379,384,98.7,4414,536,1051,3195,1986,3441,1669,1772
1803,11001001803,18.03,1136289,31909,38.9672412,-77.0419173,4148,2038,2110,96.6,36.4,1079,3145,3069,2989,502,53,1425,1644,86.7,169,333,50.8,3894,254,444,2492,1810,2102,925,1177
10400,11001010400,104,2602393,7006,38.8512668,-77.0009082,4596,1914,2682,71.4,37.4,911,3709,3685,3424,398,34,1549,2136,72.5,167,231,72.3,4530,66,389,4141,2485,3681,1549,2132
9903,11001009903,99.03,383679,0,38.888318,-76.9212121,2379,1081,1298,83.3,28.5,614,1867,1765,1587,169,48,836,929,90,59,110,53.6,2349,30,189,2120,785,1683,791,892
9904,11001009904,99.04,426198,0,38.8851712,-76.9311353,3102,1437,1665,86.3,29.7,1114,2063,1988,1938,137,4,908,1080,84.1,78,59,132.2,2948,154,55,2680,1417,1843,800,1043
9905,11001009905,99.05,431558,0,38.8843295,-76.9250522,3082,1417,1665,85.1,32.9,1006,2303,2076,2039,288,36,943,1133,83.2,98,190,51.6,2915,167,52,2798,1501,2044,928,1116
9906,11001009906,99.06,252684,0,38.8879464,-76.9359151,1832,674,1158,58.2,44.2,298,1563,1534,1462,532,51,553,981,56.4,193,339,56.9,1817,15,72,1740,998,1496,553,943
2102,11001002102,21.02,725975,0,38.9557854,-77.0142356,4859,2186,2673,81.8,39.3,842,4135,4017,3940,796,142,1755,2262,77.6,340,456,74.6,4588,271,771,3015,2504,3462,1572,1890
2201,11001002201,22.01,415173,0,38.9491337,-77.0232932,3178,1706,1472,115.9,36.7,685,2554,2493,2468,395,19,1213,1280,94.8,199,196,101.5,2918,260,802,1543,1100,2149,1069,1080
2202,11001002202,22.02,698895,566,38.9479653,-77.0118821,3486,1687,1799,93.8,30.7,944,2593,2542,2383,305,0,1187,1355,87.6,133,172,77.3,3367,119,1051,2065,1524,2358,1087,1271
2301,11001002301,23.01,407679,0,38.942552,-77.0165915,3110,1412,1698,83.2,38.3,600,2535,2510,2419,412,30,1085,1425,76.1,119,293,40.6,2938,172,822,1668,1326,2204,941,1263
6400,11001006400,64,691410,243648,38.8688572,-77.0114342,2492,1190,1302,91.4,33.4,540,2003,1952,1871,357,35,904,1048,86.3,130,227,57.3,2451,41,549,1843,1469,1895,867,1028
6500,11001006500,65,509297,0,38.883848,-77.0033314,2874,1183,1691,70,36.1,532,2421,2342,2295,395,52,1004,1338,75,136,259,52.5,2789,85,2016,349,1629,2144,947,1197
6600,11001006600,66,285156,0,38.8877585,-76.9982439,2042,994,1048,94.8,40.3,179,1877,1863,1837,465,15,899,964,93.3,224,241,92.9,1957,85,1836,38,1201,1754,874,880
6700,11001006700,67,428358,0,38.8875984,-76.989959,4266,2135,2131,100.2,39.6,730,3575,3536,3525,859,66,1742,1794,97.1,421,438,96.1,4217,49,3538,410,2129,3447,1697,1750
6802,11001006802,68.02,280108,0,38.8832158,-76.9814483,2302,1027,1275,80.5,35.4,350,1987,1952,1936,178,25,826,1126,73.4,58,120,48.3,2223,79,1431,744,1118,1932,816,1116
7408,11001007408,74.08,372349,0,38.8525662,-76.9706266,3530,1678,1852,90.6,27,1391,2151,2139,2057,201,0,1102,1037,106.3,45,156,28.8,3471,59,54,3252,1622,2109,1072,1037
7409,11001007409,74.09,404873,5767,38.8445818,-76.975165,4394,1481,2913,50.8,27.5,1721,2697,2673,2610,274,52,1030,1643,62.7,96,178,53.9,4008,386,9,3939,1894,2623,1002,1621
8904,11001008904,89.04,449343,0,38.9009808,-76.9748514,4070,2025,2045,99,34.4,972,3161,3098,3042,304,0,1642,1456,112.8,156,148,105.4,3931,139,320,3073,2178,2784,1469,1315
8802,11001008802,88.02,468578,0,38.9039498,-76.9866786,4306,2434,1872,130,33.7,754,3592,3552,3512,478,87,1955,1597,122.4,214,264,81.1,4153,153,1106,2916,2011,3383,1814,1569
9810,11001009810,98.1,398419,14058,38.826037,-77.0037886,2419,1244,1175,105.9,29.9,635,1896,1784,1714,97,0,831,953,87.2,34,63,54,2367,52,82,2184,1264,1674,721,953
10800,11001010800,108,661580,0,38.8973521,-77.044612,6199,2673,3526,75.8,20,77,6174,6122,2066,29,9,2656,3466,76.6,1,28,3.6,5880,319,4237,699,1297,5239,2221,3018
11100,11001011100,111,5718693,366232,38.9158612,-76.9681631,5192,2746,2446,112.3,42.4,898,4329,4294,4182,841,163,2323,1971,117.9,284,557,51,4768,424,786,3597,2042,4132,2229,1903
9000,11001009000,90,1427114,31550,38.9226934,-76.9545101,3566,1628,1938,84,46,583,3002,2983,2983,1214,121,1199,1784,67.2,428,786,54.5,3502,64,350,2934,2419,2970,1186,1784
9102,11001009102,91.02,1816287,0,38.9187926,-76.9888946,4820,2206,2614,84.4,32.3,1215,3705,3605,3417,496,53,1584,2021,78.4,136,360,37.8,4543,277,647,3704,2246,3390,1521,1869
9811,11001009811,98.11,467511,0,38.826651,-76.9984594,4051,1461,2590,56.4,33.6,1195,2909,2856,2706,402,8,1067,1789,59.6,132,270,48.9,4051,0,28,4023,2202,2856,1067,1789
1002,11001001002,10.02,889722,0,38.9384216,-77.0788872,3403,1641,1762,93.1,32.3,530,2909,2873,2662,170,85,1306,1567,83.3,8,162,4.9,3074,329,2494,283,2304,2568,1258,1310
10900,11001010900,109,2381015,2933566,38.8132364,-77.0238475,3634,1980,1654,119.7,27.1,1142,2569,2492,2310,268,0,1120,1372,81.6,75,193,38.9,3181,453,61,3120,1385,2384,1088,1296
7807,11001007807,78.07,522749,0,38.8985783,-76.9210632,2425,1134,1291,87.8,36.3,546,1975,1879,1780,260,37,930,949,98,85,175,48.6,2383,42,17,2352,981,1867,925,942
7806,11001007806,78.06,671434,0,38.9055926,-76.932552,2545,1454,1091,133.3,38,419,2126,2126,2096,480,39,1158,968,119.6,180,300,60,2469,76,122,2304,1307,2089,1158,931
7808,11001007808,78.08,936852,7722,38.8922212,-76.9192026,4066,1803,2263,79.7,36.2,1112,3092,2954,2785,487,14,1241,1713,72.4,183,304,60.2,4051,15,8,3988,1820,2941,1241,1700
9201,11001009201,92.01,629781,0,38.9287161,-76.9990184,3099,1522,1577,96.5,30,633,2509,2466,2188,217,36,1153,1313,87.8,110,107,102.8,2854,245,1733,845,1381,2282,1039,1243
9203,11001009203,92.03,581087,0,38.9219735,-77.0054956,3095,1172,1923,60.9,35.3,453,2652,2642,2612,257,17,1082,1560,69.4,116,141,82.3,2809,286,788,1908,1516,2482,973,1509
9301,11001009301,93.01,1109091,0,38.9307613,-76.9864892,3529,1866,1663,112.2,44,549,3039,2980,2930,476,27,1557,1423,109.4,137,339,40.4,3264,265,1895,1221,1545,2955,1557,1398
9302,11001009302,93.02,391905,0,38.9251636,-76.9907773,1629,865,764,113.2,37.8,250,1379,1379,1321,128,31,717,662,108.3,43,85,50.6,1488,141,489,750,838,1273,639,634
1100,11001001100,11,1676650,0,38.9572432,-77.0776732,4521,2019,2502,80.7,48.7,759,3839,3762,3721,1215,130,1639,2123,77.2,562,653,86.1,4285,236,3185,685,2356,3535,1514,2021
1200,11001001200,12,1219204,0,38.9462221,-77.0705215,5105,2477,2628,94.3,41.9,829,4327,4276,4185,1215,98,1983,2293,86.5,460,755,60.9,4728,377,3740,495,2701,3771,1892,1879
1401,11001001401,14.01,788095,0,38.9653036,-77.0706075,3474,1703,1771,96.2,39.1,953,2544,2521,2513,572,40,1206,1315,91.7,238,334,71.3,3219,255,2252,183,1364,2218,1123,1095
9801,11001009801,98.01,431384,7884,38.8328939,-76.9963306,1816,596,1220,48.9,47,379,1477,1437,1368,598,24,429,1008,42.6,100,498,20.1,1770,46,46,1682,1233,1428,429,999
2801,11001002801,28.01,171910,0,38.9349477,-77.0345166,4087,2008,2079,96.6,28.5,924,3243,3163,3039,198,17,1459,1704,85.6,115,83,138.6,3680,407,1655,1088,1877,2528,1173,1355
2802,11001002802,28.02,229696,0,38.9294344,-77.0346327,5219,2354,2865,82.2,32.4,934,4387,4285,4181,408,0,2027,2258,89.8,105,303,34.7,4822,397,1979,1045,2774,2937,1384,1553
7709,11001007709,77.09,828872,82685,38.879862,-76.9675363,2186,922,1264,72.9,35.7,483,1775,1703,1672,353,56,716,987,72.5,97,256,37.9,2137,49,42,2058,1332,1692,710,982
7809,11001007809,78.09,535254,0,38.9015402,-76.9321955,2969,1392,1577,88.3,31.1,849,2168,2120,2070,325,5,817,1303,62.7,72,253,28.5,2856,113,73,2783,1337,2047,792,1255
7903,11001007903,79.03,247945,0,38.8964252,-76.9743021,1831,909,922,98.6,36.1,309,1545,1522,1513,165,40,729,793,91.9,75,90,83.3,1714,117,498,1121,901,1479,697,782
8001,11001008001,80.01,322795,0,38.8961726,-76.9866524,3017,1648,1369,120.4,38.2,622,2395,2395,2365,224,42,1272,1123,113.3,45,179,25.1,2960,57,2158,676,1595,2238,1168,1070
9400,11001009400,94,1582882,0,38.9368061,-76.9742464,4932,2190,2742,79.9,38.8,1123,3864,3809,3733,852,93,1727,2082,82.9,248,604,41.1,4712,220,1058,3328,1943,3659,1629,2030
9503,11001009503,95.03,1423609,0,38.9434458,-76.9845276,3005,1430,1575,90.8,38.1,721,2315,2284,2227,683,63,1078,1206,89.4,269,414,65,2964,41,716,2216,1271,2280,1078,1202
9504,11001009504,95.04,1033168,0,38.9409032,-76.9931121,3192,1359,1833,74.1,40.6,384,2827,2808,2768,735,158,1169,1639,71.3,147,588,25,3133,59,928,1791,1348,2598,1054,1544
9505,11001009505,95.05,1033208,0,38.9618925,-77.0051999,4177,1923,2254,85.3,36.9,803,3460,3374,3321,584,158,1403,1971,71.2,202,382,52.9,4024,153,578,3261,1971,3296,1403,1893
1902,11001001902,19.02,877346,0,38.9639299,-77.0156458,2385,1101,1284,85.7,43.6,536,1882,1849,1769,392,65,852,997,85.5,178,214,83.2,2146,239,545,1324,908,1703,773,930
9907,11001009907,99.07,466954,0,38.8827718,-76.9388146,2483,1276,1207,105.7,28.1,591,1952,1892,1722,252,0,937,955,98.1,153,99,154.5,2469,14,44,2425,1114,1865,925,940
2501,11001002501,25.01,543460,0,38.9446515,-77.0317348,2876,1612,1264,127.5,39.2,663,2308,2213,2174,283,38,1209,1004,120.4,84,199,42.2,2617,259,606,1321,1082,1657,920,737
2302,11001002302,23.02,2010924,5298,38.934127,-77.0095843,1648,1017,631,161.2,48.1,154,1503,1494,1464,608,345,890,604,147.4,534,74,721.6,1550,98,602,778,1226,1373,826,547
2400,11001002400,24,556408,0,38.9417822,-77.0224058,3922,1927,1995,96.6,39.5,592,3422,3330,3288,409,62,1686,1644,102.6,125,284,44,3382,540,1771,1348,1604,2913,1410,1503
7000,11001007000,70,439473,0,38.8812697,-76.9959451,2702,1392,1310,106.3,36.5,436,2281,2266,2093,306,14,1243,1023,121.5,132,174,75.9,2549,153,2202,148,1215,2227,1227,1000
7100,11001007100,71,602223,149901,38.8771811,-76.986838,3403,1801,1602,112.4,32,627,2926,2776,2405,331,44,1470,1306,112.6,162,169,95.9,3296,107,1260,1919,1500,2622,1387,1235
6900,11001006900,69,398513,0,38.8836933,-76.9873112,2806,1368,1438,95.1,34.7,689,2301,2117,2083,249,52,1079,1038,103.9,119,130,91.5,2579,227,2101,334,1287,2063,1071,992
9507,11001009507,95.07,295290,0,38.9584945,-76.9977787,1685,777,908,85.6,39.8,376,1314,1309,1299,280,40,590,719,82.1,60,220,27.3,1569,116,115,1335,658,1256,552,704
9508,11001009508,95.08,962212,0,38.9536826,-76.9985582,3972,1592,2380,66.9,38.7,1010,3239,2962,2937,730,149,1299,1663,78.1,174,556,31.3,3686,286,210,3099,1937,2789,1227,1562
9509,11001009509,95.09,648848,0,38.949214,-76.9950319,3205,1453,1752,82.9,43.1,583,2669,2622,2567,627,156,1026,1596,64.3,153,474,32.3,3192,13,513,2420,1420,2454,930,1524
9700,11001009700,97,403051,3427,38.8354183,-76.9870248,3556,1724,1832,94.1,36.1,942,2633,2614,2449,493,288,1245,1369,90.9,396,97,408.2,3556,0,55,3489,1950,2582,1223,1359
